##########################################
#       C                       C        #
#                   C                    #
########                                C#
#$ GGGGG                         C     C@|
########         C                      C#
#                                        #
#         C              C               #
#                                C       #
##########################################