##########################################
#     L                R                 #
#         R  ? ? ? ? ?        L          #
#???????????? ? ? ? ?                    #
|@        R      R                       #
#????????????              L             #
# $??????????? ? ? ?              L      #
#R??????????? ? ? ? ?                    #
#RRRR        L        L     L            #
##########################################